...................
..Xxxxx########....
...###x########....
...###x########....
...###x########....
...###x########....
...###x########....
...###x............
...###xxxxxx@......
...###.............
...###..##########.
...###..##########.
....##..##########.
....##..##########.
....##..##########.
....##..##########.
....##.............
...................
